###############
#       #    E#
#       #     #
#  ### ##   ###
#   #   ##    #
# B #         #
#W  #         #
###############