###############
# W     #E    #
#    B  #     #
#  ######## ###
#   #         #
#             #
#   #   #     #
###############